







                          ######  ##       ########    ###    ########  
                         ##    ## ##       ##         ## ##   ##     ## 
                         ##       ##       ##        ##   ##  ##     ## 
                         ##       ##       ######   ##     ## ########  
                         ##       ##       ##       ######### ##   ##   
                         ##    ## ##       ##       ##     ## ##    ##  
                          ######  ######## ######## ##     ## ##     ## 

						      press enter